10 10
@ @ @ @ @ @ @ @ @ @
@ . . . @ . . . . @
@ . @ . @ . @ @ . @
@ . @ . . . @ . . @
@ . @ @ @ . @ . @ @
@ . . . @ . . . . @
@ @ @ . @ @ @ @ . @
@ . . . . . . @ . @
@ . @ @ @ @ . . . @
@ @ @ @ @ @ @ @ @ @
8
1 1 8 8
1 3 8 6
2 8 1 8
3 8 2 8
5 5 7 3
7 3 5 5
8 1 1 1
8 3 1 3
