s
9 9
@ @ @ @ @ @ @ @ @
@ . . @ . . . . @
@ . . @ . @ @ . @
@ . . . . @ . . @
@ @ @ @ . @ . @ @
@ . . . . . . . @
@ . @ @ @ @ @ . @
@ . . . . . . . @
@ @ @ @ @ @ @ @ @
2
1 1
7 7
3
7 1
1 7
4 4
4 4
0 1 2
