s
7 7
@ @ @ @ @ @ @
@ . . . . . @
@ . @ @ @ . @
@ . @ . . . @
@ . @ @ @ . @
@ . . . . . @
@ @ @ @ @ @ @
2
1 1
5 5
2
1 5
5 1
3 3
0 1
